############
#        O #
#   P   ####
#          #
###### #   #
#   O# #   #
#    # #   #
#          #
#       XX #
#       #  #
############
