########
#      #
# XXXXX#
# OOO  #
# OPO  #
########
